########
#......#
#.#P...#
#......#
########